NO ./texture/1.xpm
SO ./texture/2.xpm
WE ./texture/3.xpm
EA ./texture/4.xpm

F 255,222,0
C 255,211,1


  1111111111111111
  1000000000000111
  10000000000001111111111
111000000000001111
1000000011100000011
1000000010100000011
11100000000N000011111111
1110000111000000011
110000000000000001111
111000011100000000001
111111111111111111111
