NO ./texture/1.xpm
SO ./texture/2.xpm
WE ./texture/3.xpm
EA ./texture/4.xpm

F 255,222,0
C 255,211,1


  111111111111111
  1000000000000111
  10010N01001100111111
  10011111000110000001
1110000100000000000011
1110000100000000111111
111000010000000011
111000010000000011
111000010000000001
100000000000011111
11111111111111
