NO ./texture/brown_wall.xpm
SO ./texture/stone_wall.xpm
WE ./texture/castle_wall.xpm
EA ./texture/future_wall.xpm

F 233,150,122
C 0,191,255

       1111111111111111111111111
       1000000000110000000000001
       1011000001110000000000001
       10010000000000000000000011
111111111011000001110000000000001
100000000011000001110111100011111
11110111111111011100000010001
11110111111111011101010010001
11000000110101011100000010001
10000000000000001100000010001
10000000000000001101010010001
11000001110101011111011110S0111
11110111 1110101 101111010001
11111111 1111111 111111111111
