NO ./texture/1.xpm
SO ./texture/2.xpm
WE ./texture/3.xpm
EA ./texture/4.xpm

F 255,222,0
C 255,211,1


  1111111111111111
  1000000000000111
  10000000000001111111111
1110001111000000000001111
11100000000N000011111111
111000000000000011
111000000000000001
111111111111111111
