NO ./texture/1.xpm
SO ./texture/2.xpm
WE ./texture/3.xpm
EA ./texture/4.xpm

F 255,222,0
C 255,211,1


  111111111111111
  1000000000000111
  100000000000011111111
  100000001110000000001
11100000000000000000111
11100000N0000000111111
111000000000000011
111000000000000011
111000000000000001
100000000000011111
11111111111111
