NO ./images/NO.xpm
SO ./images/SO.xpm
WE ./images/WE.xpm
EA ./images/EA.xpm

F 233,150,122
C 0,191,255

       1111111111111111111111111
       1000000000110000000000001
       1011000001110000000000001
       10010000000000000000000011
111111111001000001110000000000001
100000000011000001110111100011111
11110111111111011100000010001
11110111111111011101010010001
11000000110101011100000010001
10000000000000001100000010001
10001000000000001101010010001
11000001110101011111011110111
1111S111 1110101 101111010001
11111111 1111111 111111111111
