NO ./test/this_is_north
SO ./test/this_is_south
WE ./test/this_is_west
EA ./test/this_is_east

F 255,222,0
C 255,211,1









111111111   1111
110100001   1101
10001N011   11111
111111111

111
111
111
11
1111










