NO ./texture/1.xpm
SO ./texture/2.xpm
WE ./texture/3.xpm
EA ./texture/4.xpm

F 255,222,0
C 255,211,1


  11111111111111
  100000000000011
  1001N0010011001
  100111110001101
11100001000000001
10000000000001111
11111111111111
