NO ./texture/1.xpm
SO ./texture/2.xpm
WE ./texture/3.xpm
EA ./texture/4.xpm

F 255,222,0
C 255,211,1



 11111111
110000011 
10000N01
11111111
111

