NO ./texture/1.xpm
SO ./texture/2.xpm
WE ./texture/3.xpm
EA ./texture/4.xpm

F 255,222,0
C 255,211,1









111111111   1111
1101N0001   1101
100011011   11111
111111111

111
111
111
11
1111










