NO ./images/NO.xpm
SO ./images/SO.xpm
WE ./images/WE.xpm
EA ./images/EA.xpm

F 233,150,122
C 0,191,255


11111
10001111
10N00001
10001111
11111