      1111
     10001
  1111001
  111111
