111111111
110000801
1000N0011
111111111