111111111
110000001
1000N0011
11111111
111111111