XXXXXXXXXXX
XXXXXX1111X
XXXXX10001X
XX1111001XX
XX111111XXX
XXXXXXXXXXX
